1111111111111111111111
1E000000C00010C01010C1
1010010100100101001001
1010010010101010001111
1P0000000C11C001111001
1111111111111111111111