1111111111111111111111
1C000000C000000C0000C1
1010010100100000101001
1010010010101010001001
1P0000000C00C0000000E1
1111111111111111111111