1111111111111111111111
1E001100C000000C0000C1
1001010100100000101001
1110010010101010101001
1P0000000C00C000000001
1111111111111111111111