111111111111111111111111111111111111111111111
1P000000C00000000C0001100C00000C0000C0C000C01
101001010010000C01000C0000C00C00000000C00C001
1000000010C0C00C00C000C000C000000C00000C00C01
1C00000000000000C00001100C000C00C00C00C000001
1001C00100C0C00C00C111111C000C00000C00000C001
1C0000C001C100C0000111111001C0C000100C0C00C01
10000000C000C00000C00110000C0C00000C00000C001
101001010010000C01000C0000000C00C000C000C0001
1000000010C0C00C00C000C000C00000C00C00C000C01
1C00000000C000000C001100000C00C0C00C0C0000C01
100C00C000000C00C001111100C000C0C00C00C00C001
100C00C000000C00C001111110C000C00C00000C00C01
10000000C00000000C0001100C0000C00000C00C00C01
101001010010000C01000C000C0000C000C0C00000001
1000000010C0C00C00C000C000C0000C000C00C00C001
1C00000000000000C00001100C00C00000C00C000C001
1001C00100100C00C00C111111C0000C001C00C00C001
1C0000C001C100C0000111111001C00C0010C0C00C001
10000000C000C00000C001100000C0000C00000000C01
101001010010000C01000C000C0000C000000C0C00C01
1000000010C0C00C00C000C000C0000C00000C0C00001
1C00000000C000000C0011000C00C00000C0000000CE1
111111111111111111111111111111111111111111111