11111111111111111111111111111
10000100C000000C00000C0000001
10E00101001000001010010000001
10001000C000000C00000C0000001
11110100101010100010010001001
1P0000000C00C0000000000000001
11111111111111111111111111111