11111111111111111111111111111
1E100000C000000C00000C00001C1
11100101001000001010010000011
10100100101010100010010001001
1P0000000C00C0000000000000001
11111111111111111111111111111