1111111111111111111111
1C000000000100C000C0E1
1110010100010000010101
1C000100000C101C000001
1P0000000C000C0000C001
10000C0000C01000C00001
100C00C000C0000C000C01
1110000100000000C00001
1000010100100000101001
1C00010000100000C00001
100C00000100C000000001
1111111111111111111111