1111111111111111111111
10C00000000C000C00C0E1
10000101001000C0101001
1C000100000C100C000001
100C0000C000C00C000001
1CC0C000C0C00100C00C11
1100C00C00C000C0000CC1
10001000C00C00C0000001
1000010100100000101001
1C00010000C01000100001
1P0C0000C000C00C000001
1111111111111111111111