1111111111111111111111
10C00C00000C000000C0E1
100001010010000010C001
1C00010C000C000C000001
1P0000000C000C00C00001
110C0C0000C000C00C0C01
1C0000C0C00C0000C0C001
10000000100C0000C00011
10000101001000C0101001
1C00010000101000C00001
100C00000C000C00C00001
1111111111111111111111