1111111111111111111111
10C000C000C00000100C01
10000101001000C010C001
1P0C00000000C000000111
1C000110000C000C0000E1
100C00C0000C000C000111
1111100C00100C000000C1
1000000100000000111111
1000010100C000001C1C01
1C0001000000C00000C001
100C000000C00000C00001
1111111111111111111111