111111111111111111111111111111111111111111111
10C00000C00000000C000110C00000C000000C00C00E1
101001010010000C01000C00000C000000C000C0C0001
1000C00010C0C00C00C000C00000000C00000C000C001
1C00000C000000000C001100000C000C00C00C0000001
1001C00100C0C0C0C00111111C00000C000C100000001
1C0000C001C100C0000111111001C0C000100C00C00C1
10000000C000C0000C0001100000C0C000000000C0001
101001010010000C01000C0000000C00C0C000C00C001
1000000010C0C00C00C000C00000C000C0000000C0001
1P000000000000000C00110000C00C0000C00C00C0001
111111111111111111111111111111111111111111111