111111111111111111111
1E000000C000000C000C1
101001010010000101001
101001001010101001001
100000000C00C00000P1
111111111111111111111